GO:0140110
GO:0003824
GO:0038024
GO:0045735
GO:0005198
GO:0005215
GO:0005488
GO:0031386
GO:0090729
GO:0016209
GO:0098772
GO:0045182
GO:0060089
GO:0104005
GO:0140104
GO:0016020
GO:0005576
GO:0005623
GO:0009295
GO:0019012
GO:0030054
GO:0031974
GO:0032991
GO:0043226
GO:0044215
GO:0044217
GO:0044421
GO:0044422
GO:0044423
GO:0044425
GO:0044456
GO:0044464
GO:0045202
GO:0055044
GO:0097423
GO:0099080
GO:0000003
GO:0008152
GO:0001906
GO:0002376
GO:0006791
GO:0006794
GO:0040007
GO:0007610
GO:0008283
GO:0009758
GO:0009987
GO:0015976
GO:0019740
GO:0022414
GO:0022610
GO:0023052
GO:0032501
GO:0032502
GO:0040011
GO:0043473
GO:0044848
GO:0048511
GO:0048518
GO:0048519
GO:0050789
GO:0050896
GO:0051179
GO:0051704
GO:0065007
GO:0071840
GO:0098743
GO:0098754
